WWWWWWWWWW
EUWW WO  W
W WW WWW W
W   W   MW
W WG  WW W
WWWDWK  WW
W  PW W OW
W WW  KW W
W  SOWB  W
WWWWWWWWWW