WWWWWWWWWW
EUDDDDDDDW
W WWOWWWOW
WSDDPPPPMW
W WBDDWW W
WWWDWKDDWW
WSSHWDWDOW
WSWWDDKWDW
WDDSOWBDEW
WWWWWWWWWW