WWWWWWWWWW
WU W W W W
WDDDDDDDDW
WDDDDDDDDW
WDDDDDDDDW
WDDDDDDDDW
WDDDDDDDDW
WDDDDDDDDW
W  SOWBDEW
WWWWWWWWWW